<?xml version="1.0" encoding="utf-8"?>
<level index="0" tag="Test">
  <base_tile_map>
    98,98,98,99,98,98,98,98,98,99,98,98,99,98,98,98,98,98,99,98,98,98,98,98,98,98,98,98,98,98,98,98,98,98,98,98,;
    99,99,99,99,99,99,99,99,99,99,98,98,99,99,99,99,99,99,99,99,98,98,98,98,98,98,98,98,98,98,98,98,98,98,98,98,;
    99,98,98,98,98,98,98,98,98,98,98,98,98,98,98,98,98,98,98,99,98,98,98,98,98,98,98,98,98,98,98,98,98,98,98,98,;
    99,98,98,98,99,99,99,99,98,98,98,98,99,99,99,99,98,98,98,99,98,98,98,98,98,98,98,98,98,98,98,98,98,98,98,98,;
    99,98,98,98,99,99,99,99,98,98,98,98,99,99,99,99,98,98,98,99,98,98,98,98,98,98,98,98,98,98,98,98,98,98,98,98,;
    99,98,98,99,99,99,99,99,98,98,98,99,99,99,99,99,98,98,98,99,98,98,98,98,98,98,98,98,98,98,98,98,98,98,98,98,;
    99,98,98,98,98,98,98,98,98,98,98,98,98,98,98,98,98,98,98,99,98,98,98,98,98,98,98,98,98,98,98,98,98,98,98,98,;
    99,98,98,98,98,98,98,98,98,98,98,98,98,98,98,98,98,98,98,99,98,98,98,98,98,98,98,98,98,98,98,98,98,98,98,98,;
    99,98,98,98,98,98,98,98,98,98,99,99,99,99,99,99,98,98,98,99,98,98,98,98,98,98,98,98,98,98,98,98,98,98,98,98,;
    99,98,98,98,99,99,99,99,98,98,99,99,99,99,99,99,98,98,98,99,98,98,98,98,98,98,98,98,98,98,98,98,98,98,98,98,;
    99,98,98,98,98,98,98,98,98,98,99,99,99,99,99,99,98,98,98,99,98,98,98,98,98,98,98,98,98,98,98,98,98,98,98,98,;
    99,98,98,98,98,98,98,98,98,98,99,99,99,99,99,99,98,98,98,99,98,98,98,98,98,98,98,98,98,98,98,98,98,98,98,98,;
    99,98,98,98,98,98,98,98,98,98,98,98,98,98,98,98,98,98,98,99,98,98,98,98,98,98,98,98,98,98,98,98,98,98,98,98,;
    99,98,98,98,98,98,98,98,98,98,99,99,99,99,99,99,98,98,98,99,98,98,98,98,98,98,98,98,98,98,98,98,98,98,98,98,;
    99,98,98,98,99,99,99,99,98,98,98,98,98,98,98,98,98,98,98,99,98,98,98,98,98,98,98,98,98,98,98,98,98,98,98,98,;
    99,98,98,98,99,99,99,99,98,98,98,98,98,98,98,98,98,98,98,99,98,98,98,98,98,98,98,98,98,98,98,98,98,98,98,98,;
    99,98,98,98,99,99,99,99,98,98,98,98,98,98,98,98,98,98,98,99,98,98,98,98,98,98,98,98,98,98,98,98,98,98,98,98,;
    99,99,98,98,99,99,99,99,99,99,99,99,99,99,99,99,99,99,99,99,98,98,98,98,98,98,98,98,98,98,98,98,98,98,98,98,;
    98,98,98,98,98,98,98,98,98,98,98,98,98,98,98,98,98,98,98,98,98,98,98,98,98,98,98,98,98,98,98,98,98,98,98,98,;
    98,98,98,98,98,98,98,98,98,98,98,98,98,98,98,98,98,98,98,98,98,98,98,98,98,98,98,98,98,98,98,98,98,98,98,98,;
    98,98,98,98,98,98,98,98,98,98,98,98,98,98,98,98,98,98,98,98,98,98,98,98,98,98,98,98,98,98,98,98,98,98,98,98,;
    98,98,98,98,98,98,98,98,98,98,98,98,98,98,98,98,98,98,98,98,98,98,98,98,98,98,98,98,98,98,98,98,98,98,98,98,;
    98,98,98,98,98,98,98,98,98,98,98,98,98,98,98,98,98,98,98,98,98,98,98,98,98,98,98,98,98,98,98,98,98,98,98,98,;
  </base_tile_map>
</level>